NO asset/wall.xpm42
SO asset/wall.xpm42
EA asset/wall.xpm42
WE asset/wall.xpm42

F 254,100,0
C 225,30,0

111111111111
10000 00N111
111111111111
