NO asset/wall.xpm42
SO asset/wall.xpm42
EA asset/wall.xpm42
WE asset/wall.xpm42

F 100,0
C 225,30,0

111111111111
10000000N111
111111111111
