SO   ./assets/tex/green42_SD.xpm42
EA   ./assets/tex/wood42-legion_SD.xpm42
WE   ./assets/tex/wood42_SD.xpm42
NO   ./assets/tex/blue42_SD.xpm42
NW   ./assets/tex/window42_SD.xpm42

F 106,106,106
C 173,173,173

12121211212121      112121
10000001000001      100002
20000001000001      100002
1000000100000111111111D111
2000000D000000000000000001
10000001000000000000000002
20000001000111000000000001
100000011111 Z000000000002
20000001     1000000000001
10000001     1000000000002
20000001111111000000000001
10000001000001000000000002
20000001000001001111111101
1000000D00000D000000000002
20000001111111000000000001
111111D1     1000000000002
10000001     1000000000001
20000001     1000000000002
10000001111111000000000001
2000000D000000000000000002
10000001110111000000000001
11111111 101 1000000000002
         101 1111111111111
112121211101 1
10000000010111    1111111
1000000001000111111000002
1000000000000D00000000022
111111110000011010110022
       1000001000000221
       10000010000002
       10000000000002
       10010011111111
     11100100100002
     1E000100D00001
     10000000100002
     11111111111111
