SO   ./assets/tex/green42.xpm42
EA   ./assets/tex/wood42_legion.xpm42
WE   ./assets/tex/blanc42.xpm42
NO   ./assets/tex/blue42.xpm42

F 106,106,106
C 173,173,173

12929291292921      192921
10000009000009      100002
20000009000009      100002
1000000900000311111111D111
2000000D000000000000000001
10000009000000000000000002
20000009000989000000000001
1000000388880Z000000000002
20000003000004000000000001
10000003000004000000000002
20000009345679000000000001
10000009000009000000000002
20000009000009001111111001
1000000D00000D000000000002
20000009999999000000000001
111111D1000009000000000002
10000001000009000000000001
20000001000009000000000002
10000001111119000000000001
2000000D000000000000000002
10000009990911000000000001
11111111 909 1000000000002
         909 1111111111111
192929888909 
10000000090911   1999991
100000000900199991000002
100000000000D00000000022
11111111000091010110022
       100009000000221
       1000090000002
       1000000000002
       1001091111111
     1110010900002
     4E00010D00001
     4000000900002
     1999999999991
