SO   ./assets/textures/green42_SD.xpm42
EA   ./assets/textures/wood42-legion_SD.xpm42
WE   ./assets/textures/wood42_SD.xpm42
NO   ./assets/textures/blue42_SD.xpm42
NW   ./assets/textures/window42_SD.xpm42

F 106,106,106
C 173,173,173

12121211212121      112121
10000001000001      100002
20000001000001      100002
10000001000001111111110111
20000000000000000000000001
10000001000000000000000002
20000001000111000000000001
10000001111100000000000002
20000001   111000000000001
10000001   100000000000002
20000001111111000000000001
10000001000001000000000002
20000001000001001111111101
10000000000000000000000002
20000001111111000000000001
11111101     1000000000002
10000001     1000000000001
20000001     1000000000002
10000001111111000000000001
20000000000000000000000002
11111111110111000000000001
         101 1000000000002
         101 1000000000001
112121211101 1111111111111
1000000001011111110000002
1000000000000100000000002
1000000000000000000000022
111111110000010000000022 
       1000001101011222
       10000010000002    
       10000000000002    
       10010011111111    
     11100100100002    
     1E000100000001    
     10000000100002    
     11111111111111    