SO   ./assets/textures/green42_SD.xpm42
EA   ./assets/textures/wood42-legion_SD.xpm42
WE   ./assets/textures/wood42_SD.xpm42
NO   ./assets/textures/blue42_SD.xpm42
NW   ./assets/textures/window42_SD.xpm42

F 106,106,106
C 173,173,173

112121212121212121      11212121
100000000000000001      10000002
200000000000000001      10000002
10000000000000000111111111011111
20000000000000000000000000000001
10000000000000000000000000000002
20000000010000011100000000000001
10000000011111110000000000000002
2000000001     11100000000000001
1000000001     10000000000000002
20000000011111111100000000000001
10000000000000000000000000000002
20000000000000000000000000000001
10000000000000000000000000000002
20000000011111111100000000000001
1111111101       100000000000002
1000000001       100000000000001
2000000001       100000000000002
10000000011111111100000000000001
20000000000000000000000000000002
11111111111110011100000000000001
            1001 100000000000002
1121212121111001 100000000000001
1000000000001001 111111111111111
10000000000000011111110000000002
10000000000000000000000000000002
10000000000000000100000000000022
1111111111000000000000000000022 
         100000001010111112222
         1000000000000000001    
         1000000000000000001    
         1000010000111111111    
       1110000100000000002    
       1E00000100000000001    
       1000000000000000002    
       1111111111111111111    