WE ./assets/textures/window42_SD.xpm42
NO ./assets/textures/blue42_SD.xpm42
SO ./assets/textures/green42_SD.xpm42
EA ./assets/textures/wood42-legion_SD.xpm42

F 106,106,106
C 173,173,173

111111111111111111      11111111
100000000000000001      10000001
100000000000000001      10000001
10000000000000000111111111011111
10000000000000000000000000000001
10000000000000000000000000000001
10000000010000011100000000000001
10000000111111110000000000000001
1000000001     11100000000000001
1000000001     10000000000000001
1000000001     11100000000000001
10000000000000000000000000000001
10000000000000000000000000000001
10000000000000000000000000000001
10000000011111111100000000000001
1111111101       100000000000001
1BBBBBBB01       100000000000001
1BBBBBBB01       100000000000001
1BBBBBBB01       100000000000001
10000000000000000000000000000001
11111111111110011100000000000001
            1001 100000000000001
1111111111111001 100000000000001
1000000000001001 111111111111111
10000000000000011111110000000001
10000000000000000000000000000001
10000000000000000100000000000001
11111111110000000000000000000001
         10000000001011111111111
         1000000000000000001    
         1000000000000000001    
         1000010011111111111    
1111111111000010000000000001    
1E00000000000010000000000001    
1000000000000000000000000001    
1111111111111111111111111111    