









EA   ./assets/tex/wood42_legion.xpm42
SO   ./assets/tex/green42.xpm42


F 100,100,90

WE   ./assets/tex/blanc42.xpm42
NO   ./assets/tex/blue42.xpm42
C 173,190,2


1111111111111111                1111111111
1000000000000001                1000000001
100000001110000111              1000000001
10000100010100001               1000010001
10000000111000011               1000000001
1000S0000000000111111111111111111000000001
100000000000000000000000000000000000000001
111111111111111111111111111111111111111111