

WE       ./assets/tex/window42_SD.xpm42

     NO ./assets/tex/blue42_SD.xpm42

F 106,106, 106

SO ./assets/tex/green42_SD.xpm42

EA ./assets/tex/wood42-legion_SD.xpm42
NW   ./assets/tex/window42_SD.xpm42



C     173, 173, 173




111111111
100000001
101000201
100000001  111
100E00001  101
100000001  111
101000101
100000001
111111111