

WE       assets/tile_wall_window_left.xpm

     NO assets/tile_wall_window_bottom.xpm

F 220,100,10

SO assets/tile_wall_window_right.xpm

EA assets/tile_wall_window_top.xpm





C     225,30,0





1111111
1000101    111
1110011    1 1
1100N1     111             1
111111