

WE       assets/tile_wall_window_left.xpm

     NO assets/tile_wall_window_bottom.xpm

F 220,100,10

SO assets/tile_wall_window_right.xpm

EA assets/tile_wall_window_top.xpm





C     225,30,0




111111111111111111111111111111111111111111111111
1              00              00              1
1              11              11       1      1
1              11              11       1      1
1                 1            11              1
111111111111111   1111111111111111111111 1111111
111111111111111   111111111111111111111101111111
1              000             11              1
1              11              00              1
1              11              11              1
1              11              11              1
1 1111111111111111111110011111111111111  1111111
11111111111111111111110011111111111111  11111111
               11              11              1
               11                              1
      1        11              11       N      1
      0        11              11              1
               111111111111111111111111111111111

               1