

WE       bonus/asset/textures/eagle.xpm

     NO ./bonus/asset/textures/redbrick.xpm

F 119, 119, 119

SO bonus/asset/textures/greystone.xpm

EA bonus/asset/textures/wood.xpm





C     0, 0, 0




111111111
100000001
101000101
100000001  111
100E00001  101
100000001  111
101000101
100000001
111111111