

WE       assets/tile_wall_window_left.xpm

     NO assets/tile_wall_window_bottom.xpm

F 220,100,10

SO assets/tile_wall_window_right.xpm


EA assets/tile_wall_window_top.xpm






C     225,30,0




   F
 111110
 100101
111001
1100N1
111111